WWWWWWWWWWWWWWW
WGGGGGGGGGGGGGW
WGGGSSSGGGSSSGW
WGGGSGGGGGGSGGW
WGGGSGTTTTGSGGW
WGGGSGTTTTGSGGW
WGGGSGTTTTGSGGW
WGGGSGTTTTGSGGW
WGGGSGTTTTGSGGW
WGGGSGGGGGGSGGW
WGGGSSSGGGSSSGW
WGGGGGWWWWGGGGW
WGGGGGWSSWGGGGW
WGGGGGWWWWGGGGW
WWWWWWWWWWWWWWW