# Mapa de exemplo - 21x17 tiles
# G = Grass (grama) - caminhável
# S = Stone (pedra) - não caminhável  
# W = Wall (parede) - não caminhável
# T = Water (água) - não caminhável
# D = Dirt (terra) - caminhável
# A = Sand (areia) - caminhável

WWWWWWWWWWWWWWWWWWWWW
WGGGGGGGGGGGGGGGGGGW
WGGGSSSSSSSSSSSGGGW
WGGGSGGGGGGGGGSGGGW
WGGGSGGGTTTTGGSGGGW
WGGGSGGTTTTTGGSGGGW
WGGGSGGTTTTTGGSGGGW
WGGGSGGTTTTTGGSGGGW
WGGGSGGGTTTTGGSGGGW
WGGGSGGGGGGGGGSGGGW
WGGGSSSSSSSSSSSGGGW
WGGGGGGGGGGGGGGGGGGW
WGGGDDDDDDDDDDDGGGW
WGGGDAAAAAAAAADGGGW
WGGGDAAAAAAAAADGGGW
WGGGDDDDDDDDDDDGGGW
WWWWWWWWWWWWWWWWWWWWW