#########################
#.......................#
#..........###..........#
#.........#...#.........#
#.........#...#.........#
#..........###..........#
#.......................#
#.......................#
#.......................#
#......#########........#
#......#.......#........#
#......#.......#........#
#......#.......#........#
#......#########........#
#.......................#
#.......................#
#.......................#
#..........#########....#
#..........#.......#....#
#..........#.......#....#
#..........#.......#....#
#..........#########....#
#.......................#
#.......................#
#########################