###########pp############
#.......................#
#.......................#
#.......................#
#.......................#
#.......................#
#.......................#
#.......................#
#.......................#
#......#########........#
#..............#........#
#......#.......#........#
#......#................#
#......#########........#
#.......................#
#.......................#
#.......................#
#..........#.#######....#
#..........#.......#....#
#..........#.......#....#
#..........#.......#....#
#..........####.####....#
#.......................#
#.......................#
#########################