WWWWWWWWWWWWWWW
WGGGGGGGGGGGGGW
WGGGGGGGGGGGGGW
WGGGGGTTTTGGGGW
WGGGGGTTTTGGGGW
WGGGGGTTTTGGGGW
WGGGGGTTTTGGGGW
WGGGGGTTTTGGGGW
WGGGGGTTTTGGGGW
WGGGGGTTTTGGGGW
WGGGGGGGGGGGGGW
WGGGGGWWWWGGGGW
WGGGGGWWWWGGGGW
WGGGGGWWWWGGGGW
WWWWWWWWWWWWWWW