WWWWWWWWWWWWWWW
WGGGGGGGGGGGGGW
WGGGGGGGGGGGGGW
WGGGGGTTTTGGGGG
WGGGGGTTTTGGGGG
WGGGGGTTTTGGGGG
WGGGGGTTTTGGGGG
WGGGGGTTTTGGGGG
WGGGGGTTTTGGGGG
WGGGGGTTTTGGGGG
WGGGGGGGGGGGGGW
WGGGGGWWWWGGGGG
WGGGGGWWWWGGGGG
WGGGGGWWWWGGGGG
WWWWWWWWWWWWWWW